0000000000000
0202020202020
0202020202020
0202021202020
0202020202020
0202000002020
0000020200000
1022000002201
0000022200000
0202020202020
0202020202020
0202000002020
0000000200000