..........
##.....##.
#.......#.
...###....
..........
..........
..#####...
..........
#........#
##......##