0000000000000
0022000000222
0200203302000
2000233332000
2000231132202
0002444444222
0222112112222
0022102012220
0022222222220
2322211222232
2333333333332
0033300033330
0002000200200