0000000000000
0022220200000
0002020220333
0000000103333
0002221223321
0222100203300
0222013333300
0001003333320
1203333133320
0233333000022
0233000012220
0033000002000
0033000200000