0000000000000
0222000002000
0000202000022
0444440220021
0000040201120
2022244404220
0000140004100
4440442204000
0000021104440
2220000000000
0020110002200
2000000002002
0000000200000