0000000000000
0222200022220
0200002000010
0202200022022
0202301030012
0200333330012
2000333330002
2102311130020
2202000002010
2100002000020
2222200022211
2200200020020
2200000200000