0000000000000
3300022200033
3000222222003
0002232322000
0002332332000
3002222222003
3300232320033
4440222220444
0000000000000
0000222220000
0000000000111
2220000000000
1110000201000