0000000000000
0332200020000
3333333322000
3123222333321
3323331332120
0332033332020
0222223322233
0122000220003
0202000233223
0200012332003
0222000003233
0020022203230
0020020203330