0000000000000
0013100000000
0003030000000
0300003000000
0330030300000
0303030030000
0300300033000
0030000333300
0003003033330
2000003003331
2200000003333
1220022200333
1122020200033