0000000000000
0202200555500
0000200555550
0550200055550
0550222000000
0000000002011
2222000222022
0022220000000
0000000222020
0555000002020
0555000000020
0555022202000
0000020202020