0000000000000
0202200555220
0200201555550
5551200255550
5555552202000
0005555202011
2222555555522
0002255550000
0222055522020
5552500002020
5555510100020
2555500002000
2210000202020