0000000000000
0200000010010
2320002222010
0232002032110
0020312302000
0000102122000
0022120100000
0020321300000
1113020022000
1022220021100
1001000001220
3111022200211
0000020200011