0000000000000
0202020202020
0101010101010
0000200020000
2022202022202
1010101010101
3300203020033
3333223223333
3333333333333
0000233320000
0202000002020
0202022202020
0202020202020