..........
..##..##..
#.......#.
...###....
.####..##.
..........
..#####...
........#.
#......##.
##.....##.