0001000100000
0201000202020
0200000202120
0002000001000
0002001002320
0300020000300
0222333100320
0001320202020
1201020200020
0202022202020
0202000000000
0200022202020
0202020202220