0000000000000
0000000020100
0004001020200
1024010020200
0024000200000
2024404444002
0000000304011
2202013334000
2000023334020
0000020304030
0200022200333
0202000004333
0000000204030