0000000000000
0022222222000
0333333332200
3300000033220
3010010003330
3010010003330
3003000033222
3333333332222
2332233322220
0222222222201
1021222222201
0122100022111
0000000200000