0000000000000
0022222222000
0333333332200
3300000033220
3010010003330
3010010003330
3003000033222
3333333332222
2332233322220
0222200022201
1021000002201
0122022202111
0000020200000