0000000000000
0000313000000
0030030033000
0323000322300
0032300033003
3003003000031
2300031300303
1230003003130
2300300030300
3003230323000
0003000000030
0300022200313
3130020203230