0000000000000
0000011000000
0000001000000
0113321233110
0001331331000
3000133310003
1300033300031
3000013100003
0000100010000
0001001001000
0000000000000
0000000000000
0010000200100