0000000000000
0020230222200
0330230200010
3333332220020
0033001200220
2100220000000
0000000555550
0020055555550
0010555555550
2020555555550
0020000005550
0020022205550
0020020200000