0000000000000
0020230222200
0330230200011
3333332220020
0033001200220
2100220002200
0002555555555
0020555555555
0010555555555
2020555555555
0020000005555
0020022205555
0020020205555