0000000000000
0020230222200
0330230200011
3333332220020
0033001200220
2100220002200
0002555555555
0020555555555
0010555555555
2020555555555
0020555555555
0020000055555
0020000205555