0000000000000
0202000001000
0202001001011
0200020120001
0000220220100
0010200220220
1010020100120
0022020002100
0122022022002
0200021000022
0002022101002
2022000002100
2020000202220