0000000000000
0004302000000
3000001020440
3301000013400
3330010000000
3310000100003
3100210001033
0000022100333
0043000220133
0440000000003
0000000034001
1000000004400
1100000200001