0000000000000
1100100110000
0100100010113
0100111030100
0200001011100
3110121220000
0013130020011
0010030010010
0020010011210
3111332110210
0002000033020
0001000003020
0001000201020