0000000000000
0000000000100
0000003002200
0000033302200
0000335332200
0003355533200
0033555553300
0335555555330
3355555555533
0355555555530
0355000005530
0355022205530
0355020205530