0000000000000
0000003000100
0000333332200
0003300033220
0033005003320
0330055500330
3300555550033
3005555555003
3055555555503
3055555555503
3055000005503
3055022205503
3000020200003