0000000000000
0244010200000
0044233344010
0000033344200
0100440300000
3320441000020
3330000001001
0244020000000
1044334433020
0000304433440
0001000003440
0020022200000
2000020202100