0000000000000
0333200000000
2333000000000
3333000202222
3333022202000
3333002000000
0300001110030
0000000003333
2202202223333
0000020003333
2001000003330
2201000003330
1220000200000