..........
...#...#..
#.......#.
##..##....
###....##.
##........
####..#...
........#.
.......##.
##........