0000000000000
0000000000000
0000033000300
0330333303330
3333333333333
1343333343333
3344433344431
3333431333433
3333333333333
3333322333331
1333000003310
0122022202200
0000020200000