0000000000000
3300022000003
3000222222001
1002222222220
0002000222020
4000101022000
0020000022044
0022222222000
0022222222200
0222222222200
0220000002203
3022022202033
1300020200331