0000000000000
0000200011100
1020002000000
2022202204404
2000200004000
0000440444022
2200420220000
0000400000010
4440401020000
0000000000022
0000000000000
2220022202200
2000020200000