0000000000000
0200200003203
0200202003203
0200201023023
0000102021033
2220032300022
0000033320000
1220233320221
1110003000111
0200200020000
0220000000023
0020022200333
0000020200033