0000000000000
0011110000100
0010003011100
0100031000100
0000311000110
0103111010000
0001100011000
1000101110000
0010001130010
0100001300110
0111000001000
0000022201001
0000020200000