0000000000000
3222020002200
3330020202002
3444444444404
0200000000000
0020002222211
2202002232002
0001000333300
4404444404444
3300000000000
3320000000020
3020022202020
0000020200020