0000000000000
2000000301102
0000301101300
0001101300000
0001300000000
0003030303000
1200110011021
0003130313000
0000000000000
2000110011002
2003000003002
0000022200000
0022020202200