..............######......
..............######......
..######..........##......
..########..##....##......
........##..##........####
........##............####
..~~~~~~~~~~..###.....##@@
..~~~~~~~~~~..###.....##..
..........~~..##..@@@.##..
....@@@@@@~~..##..@@@.##..
##..######~~~~~~..~~####..
##..######~~~~~~..~~####..
........@@~~......~~@@....
........@@~~......~~......
~~~~~~..~~~~####..~~......
~~~~~~..~~~~####..~~......
..........##@@@@..~~~~~~..
..........##......~~~~~~..
######....................
######....................
....##..@@@@......####...#
....##............####...#
##................##....##
##.........####...##....##
...........#..#...........
...........#..#...........