..........................
..........................
..........@@@@............
..........@@@@............
............@@............
............@@............
..@@@@%%%%##@@##%%%%@@@@..
..@@@@%%%%##@@##%%%%@@@@..
......@@%%%%@@%%%%@@......
......@@%%%%@@%%%%@@......
%%......@@%%%%%%@@......%%
%%......@@%%%%%%@@......%%
@@%%......%%%%%%......%%@@
@@%%......%%%%%%......%%@@
%%........@@%%@@........%%
%%......@@..%%..@@......%%
........@@......@@........
........@@..@@..@@........
......@@....@@....@@......
......@@....@@....@@......
..........................
..........................
..........................
...........####...........
....@@.....#..#.....@@....
....@@.....#..#.....@@....